能否	可以	能。。。么	能。。吗
怎么办	怎么做
损坏	辨认不清
不正当手段	欺骗	贿赂
车身	车上
注册	登记
没	尚未
漫水路	漫水桥
处罚	处理	过错	罚吗	怎么罚	怎么处罚
驾驶证	行驶证	驾驶本
为什么	原因
破坏	伪造	毁灭
高速公路	高速上	高速行车道
扣押	扣留	暂扣
怎么	如何
驾驶	行驶	开车
伪造	变造
饮酒	醉酒	喝酒
欺骗	隐瞒
快速路匝道	加速车道	减速车道
怎么样	怎么
是不是	算。。吗
新车 新买的车
买   购买
要   需要
哪个 哪家
公司 保险公司
次年 下一年
商业险 商业保险
建议  推荐
重要的 必须要上  有必要
